@The final day!!


 SSSSSSSSSSSSSSSSSSSSSSS
 SH      CCCCCC      CCS
 SV        CC          S
 S                     S
 S   SSSSSS  SSSSSS    S
 S      SSS  SSS       S
 S      S      S       S
 S    TTS      STT     S
 S      S  TT  S       S
 S    CCSM     SCC     S
 S      SSSSSSSS       S
 S         CC          S
 SH                    S
 S         CC        V S
 SSSSSSSSSSSSSSSSSSSSSSS
