@Speed thrills, but it kills!


 SSSSSSSSSSSSSSSSSSSSSSS
 S        SSSS       TTS
 S    V   CSSC  V     CS
 S   S    CSSC       CCS
 S   S    SSSS     SSCCS
 S   S    CSSC     S   S
 S C S    CSSC  T  S   S
 S C S    SSSS     S   S
 S C S CC     CC   S   S
 S C SSSSSSSSSSSSSSS   S
 S       T     CCCTS   S
 STT           CCCTS   S
 SSSSSSSSSSSSSSSSSSS  TS
 SM      CCC        CCCS
 SSSSSSSSSSSSSSSSSSSSSSS
