@Nice Job! You did well. But life, is not a single day
@every day, you get hungry, and you need the cheese.
@Go satisfy your hunger now.


 SSSSSSSSSSSSSSSSSSSSSSS
 SC                   CS
 S                     S
 S                     S
 S      SS             S
 S   C  SS    SSSSSSSSSS
 S      SS             S
 S          C          S
 S                     S
 S                     S
 SSSSSS       SS       S
 S            SS       S
 S      C     SS       S
 SM           SS      CS
 SSSSSSSSSSSSSSSSSSSSSSS
