@More cats in search of food! Not good to you.
@Escape from them to make your day..


 SSSSSSSSSSSSSSSSSSSSSSS
 S        SS    V      S
 S  C     SS           S
 S        SS           S
 S        SS       C   S
 S        V            S
 SSSSSSS               S
 S            SSSSSSSSSS
 S                     S
 S                     S
 S      C              S
 SSSSSS     SSS  SSSSSSS
 S          SC C C C C S
 SM         S C C C C CS
 SSSSSSSSSSSSSSSSSSSSSSS
