@The Last Day of the week, but you've no weekend!


 SSSSSSSSSSSSSSSSSSSSSSS
 SC      TS    CS      S
 S        S     S      S
 S              S     CS
 SSSSSSSH              S
 SC                    S
 S  T    S CC S   SSSSSS
 S       S    S       TS
 SSSSS   S SS S        S
 S       S    S  SSSS  S
 S       S CC S        S
 S  S                 TS
 S  S      S    SSSSSSSS
 SM S      S         CTS
 SSSSSSSSSSSSSSSSSSSSSSS
