@More Cats and more Traps


 SSSSSSSSSSSSSSSSSSSSSSS
 S   CCCCCCCV CCCCCC V S
 SV                    S
 S   SH            S   S
 S   S             S   S
 S       T     T       S
 S      TSSSSSSST      S
 S       SSTTTSS       S
 S      TSSSSSSST      S
 S       T     T       S
 S   SH            S   S
 S   S             S   S
 S         V           S
 SM  CCCCCC  CCCCCCC   S
 SSSSSSSSSSSSSSSSSSSSSSS
